







NO ./textures/grass.xpm
F 0,0,0


















SO ./textures/brick.xpm
WE ./textures/mossy.xpm
C 255,30,0
EA ./textures/redbrick.xpm
                                  
        1111111111111111111111111
        1000000000110000000000001
        1111111111111111111111111
        1011000001110000000000001
        1001000000000100000000001                                 
111111111011000001110000000000001
100000000011000001110111111111111              11111
11110111111111011100000010001
11110111111111011101010000001                     1
110000001101010111011100100011111
10000000000000001101 10001000111
1000000000S000001101110100011111
1100000111010101111101111000111
11110111 1110101 101111010001
11111111 1111111 111111111111











